1111111111111111111111111111111111
101000000001000C00000C000000010001
10100101000E100010100100000P011111
1010010010111010001001000000010101
100001000C00C0000000000000000000C1
1111111111111111111111111111111111
