1111111111111111111111111111111111
101000000011100C00000C000000010001
1010010100PE1000101001000000011111
1010010010111010001001000000010101
100001000C00C0000000000000000000C1
1111111111111111111111111111111111
