11111111111111111111111111111
1000E0000000C00000C0000000001
1000000000000000000000P000001
10000000000000000000000000001
10000000000000000000000000001
10000000000000000000000000001
10000000000000000000000000001
1000000C0C00000000000000000C1
10000000000000000000000000001
11111111111111111111111111111
