1111111111111111111111111111111
1000000001111N11110000001100P01
10000C0001111010110011100000001
100000000100101N110000001111111
10001111110000C0111111010000001
1000100000000010110001010111101
10001011111111101100010101E0001
100000111111C000000000010111111
1000011111111110000000000000001
1000011111111110000000000000001
1000011111111110000000000000001
1111111111111111111111111111111
