11111111111111111111111111111
1C000001000N00000000001100001
100000010010100100111000P0001
10000001001010010000001111111
10011111000000011111010000001
1001C00000000N010001010111101
10010111111111110001010100001
10000100010000000000010111111
1E0011000100000000000000000C1
11111111111111111111111111111
