11111111111111111111111111111
1010E0001100C00000C0000010001
1010010001000101001000P001111
10100100110100010010000000001
10100100110100010010000000001
10100100110100010010000000001
10100100110100010010000000001
1000010C0C00000000000000000C1
10000000000000000000000000001
11111111111111111111111111111
