1111111111111111111111111111111111
1010E0000011100C00000C000000010001
101001010000100010100100000P011111
1010010010111010001001000000010101
100001000C00C0000000000000000000C1
1111111111111111111111111111111111
