11111111111111111111111111111
1010E0001100C00000C0000010001
1010010001000101001000P011111
10100100110100010010000010101
10100100110100010010000010101
10100100110100010010000010101
10100100110100010010000010101
1000010C0C00000000000000000C1
11111111111111111111111111111
