1111111111111111111111111111111
1000000001111N11110000001100P01
100C000001111010110011100000001
100000000100101N110000001111111
10111111000000C0111111010000001
1010000000000010110001010111101
10101111111110001100010101E0001
1000111111C00000000000010111111
1001111111111000000000000000001
1001111111111000000000000000001
1001111111111000000000000000001
1001111111111000000000000000001
1001111111111000000000000000001
1001111111111000000000000000001
1001111111111000000000000000001
1001111111111000000000000000001
1001111111111000000000000000001
1001111111111000000000000000001
1001111111111000000000000000001
1001111111111000000000000000001
1111111111111111111111111111111
