11111111111111111111111111111
10P0E00100000000000000110C001
10000001001110010011100000001
10000001001010010000001111111
10011111001010011111010000001
1001C000000000010001010111101
100101111111111100010101C0001
10000100010000000000010111111
10001100010000000000000000001
11111111111111111111111111111
