11111111111111111111111111111
10000001111N11110000001100P01
100C0001111010110011100000001
1000000100101N110000001111111
100111110000C0111111010000001
10010000000010110001010111101
100101111111101100010101E0001
1000011111C000000000010111111
10001111111110000000000000001
11111111111111111111111111111
