11111111111111111111111111111
1000E0010000C00000C0000000001
10000001000000000000000000001
1000000100000000000000P000001
10000111000000000000001111111
10000000000000000000000000001
10000000000000000000000000001
1000000C0C00000000000000000C1
10000000000000000000000000001
11111111111111111111111111111
