11111111111111111111111111111
1000E001000N00000000001100001
100000010010100100111000P0001
10000001001010010000001111111
10011111001010011111010000001
1001C000000000010001010111101
10010111111111110001010100001
10000100010000000000010111111
1C0C1100010000000000000000001
11111111111111111111111111111
