11111111111111111111111111111
10000001111N11110000001100P01
100C0001111010110011100000001
1000000100101N110000001111111
101111100000C0111111010000001
10100000000010110001010111101
101011111111101100010101E0001
10001111110000000000010111111
10011111111110000000000000001
11111111111111111111111111111
