11111111111111111111111111111
1P00E001000000000000000000001
10000001000000000000000000001
1CCC0001000000000000000000001
10000111000000000000001111111
10000000000000000000000000001
10000000000000000000000000001
10000000000000000000000000001
10000000000000000000000000001
11111111111111111111111111111
