111111111111111111111111111111111111111
100000000000000000000000000000000000001
101111111N1111111111111111111N1111111C1
10000000000000000C110000000000000000001
111111111011111110111111111110111111111
100000000000000000110000000000000000001
101111111011111111111111111110111111111
100000000000000000110000000000000000001
111111111011111110111111111110111111111
10000000000000000C110000000000000000001
101111111011111111111111111110111111111
100000000000000000110000000000000000001
111111111111111110111111111111111111101
1P000000000000000011E000000000000000001
111111111111111111111111111111111111111
