1111111111111111111
1111111001111111111
11111111C1111111111
1111111101N11111111
10P000000C000000E01
11111111N1011111111
1111111111C11111111
1111111111001111111
1111111111111111111
