111111111111111111111111111111
1P0000001110000000111000001111
101111101011111110111111101111
100000000000000000000000000001
101111101011111110111111101111
1011C1110010000001110000000001
101100000000000001110000000001
101111111111111111111111111101
100000000001111110000000000001
10111111101C101010111111111111
1000000000001000100000000000C1
101111111010101011111111111111
100000000000000000000000000001
1011111110111111101111111E1111
111111111111111111111111111111
